XXSXXXXXX
XX X    X
XX   XX X
XX  X   X
XXXXXXX X
XXX   X X
X       X
X XXXXXXX
XEXXXXXXX
